00000000000000000000000000000000000000000000000000
01010000011111111110110111111100100100100010111110
01111111110000001010011100010011111101111110101010
01LLL100011111T01000010000010010000001000000101010
01LLL101000000001111111111111111111111111101101010
01LLL111110000010010000000100000001010100011LL1010
0111101001111111111011111011111110101001111LLL1010
0100101010000000001D1LLL1001000011001101000LLL1010
0101101010T0T11111101LLL10010100011100010111111010
0100011110100001010011LL1011111T010111110010000110
01101100111101010111011010000000010100011110011100
00101010100001110100001111111111110001010011110000
001010101111100101111001000001000001110000010111T0
01101111000000100000111101111100001100011111001000
00100101111110101011100100D0011111100T110101101110
01101101001011111010101111111000001100000000100100
010001000000000000T0101010000011100111111111111100
0111111111111111100001101111111001110010000D000110
01000000D0001000101111001001001110010010T111111010
01011111111011101001010111010000000101100010001010
01010001001001001001010101011110110100111010T010T0
01010101011101011010010101000D001001001010T0101000
01011101010101000010010111111111100010101000111110
01110001010101101011110000000010111110101111000010
00000T01010100111010011111001010100011101001010000
001001010101110100111000011110101110001010010111T0
0111010101100001000011111100101010111010100100D000
000101D10011T01111110100010010101010110010111111T0
01110101000000100101010101101010100000111010010000
0101D1011111111101010T0111001010111111000000011100
01010101010000000101000001011001010000011011010110
0T010101010010101111111T01001101011111001D10010000
0001010101101D1000100000010001D1000001001010011110
011101010011101011101101110T1101111111111010010010
00100111110100100D00010010000100000000101010010110
01101100010110T011111110111111111011111010100T0100
00101001110100000010101000000000101000101011000100
0010100101011111T0T0101110011111101010101001111110
0110T0010T0100000000101011110000001110101110100010
0010001000010111111100T010101111100010101000101010
00111110T11111000001100000000000101000100111111010
0010000000100111110011011T011111111101110101000010
0111011111000100010001D100010000000101010101110010
0101D1000010111111001101111100011T01010T0111011010
00010111101010000110100100011111000110000001001110
011101001D1011110010110101000001111011111101001000
01010100101000001010010111111001001001000101001010
00010110101001111011010000001111001100000100111110
0T110100T01111001010011111110001110111111011100010
00000000000000000000000000000000000000000000000000