00000000000000000000
01110100011111111110
01110111110101000010
01T1D100000101011010
01110111111101001010
01110101010000111010
00000101011111001110
001110010000D0001000
01101111111111011110
000000000D0000010100
00101111111111110100
01111000101010010100
010010T0101011010100
01000010101LL1100010
01111111101LLL111110
00010001001LLL100010
0111011101111111T010
01001100110100000010
0111101110011111T0T0
00000000000000000000