00000000000000000000
0T11110T0T0110010110
00001001010011110010
0T00111101011LL11110
010100010101LLL10000
010100010100LLL10110
01011111011111111100
01110101D10000101010
00010101011000101010
01000101001111101110
01111110011010000000
001000111100111111T0
00111010010110100000
00101010010010111110
00101011110110101010
01111000010000101010
000000101111T0T01110
00111111101000001000
011010001011111111T0
00000000000000000000