00000000000000000000
01100010111110101110
00111110100011100D00
00000010111110011110
01111110000100010000
01010011110111110010
01010001010100011110
01011111010111100000
010000011001001111T0
01110100111110000000
01011111101011110110
00000001001010100100
0111110T001010T01110
01000100011010001000
0101111111LL111111T0
0111000001LLL1010000
0001011T01LLL0011110
00110100011111101010
0110011111001010T0T0
00000000000000000000