000000000
010111110
011000100
001000100
011111100
010100100
010101110
0T0T01L10
000000000