000000000000000000
001010T11111111110
01111000001LLLLL10
01001111101LLLLL10
010001001111LLLL10
011111000001111110
000001011011000010
0T1111001010010010
000010011111111110
011010010101000010
001110010100001010
011001110111111100
000000000100000100
0T11101101111T0100
000010010101000110
011110111101010100
001011100111110110
000000000000000000