000000000000000000000000000000000000
0T110T11000000010T011111111111010110
000100011111111101010001000001110100
01111100000D000101010T11000011000110
01000100T0111111110100011111100T1100
010T11101000000010011111000011000100
010000101100100010000100000000010110
010T1111011011011111110T111111110100
010000010010011100000100010000010100
0110111111110001011111100110T0011110
001100D00001111101000011110010110000
011011111111010111000110001110010110
01000000000101010010110011100001D110
011111111100010100100111001111110110
010000100111010T00111010011010010000
000000000010010001101011110011011110
01111111T01111111100T010011101010010
00D00100001000000100001110000T010110
011101111110111111111110111100010010
000001000100100000010100100111110110
0111111T0101101111010101110101000010
01000000010010101001010101010111T010
0T0111111101100011110100010100000010
000010000100011110010111100111101110
0110101001011100000101001110001D1000
01001D1011010111110T01001011101011T0
011110100001000001000110100100100000
000100111011111011110010101011110100
010101111D10001010010010101000011110
011101111010111010111110111111101010
0001000010101010101000000D0000001010
0T1110100010001010101111111111101D10
000010111011101010110000101010101010
011110001010110010011000101010101010
00101111111001101110111110T0111110T0
000000000000000000000000000000000000