000000000000000000000000000000000000000000000000000000000000000000000000
010001011111110101011101110T11011011101000011111101111111111T11111111110
01111101000000111101010101000100101001111111000010111111111100D000000010
001001011111111001010101011011101010010000010110001111111110011111010110
0010000010100100110101D10010001010100101110100110T111111111011LLL0110010
011011101010011000010101001010101D100101010110010111100D000001LLL0100010
0100100100110011111101011110111010100101010011110T0T0T11111111LLL0111110
011110010001000000010100001001001011110101010010010100000100011111100000
000011110T1111111T01011110111101101000010111001111010T111101110000110110
011010000000000D0001010001LLL1011010110110011110010100010101011111011100
0011110110T0T0111111111101LLL1000010010011110010010101110101000001000000
00000100101010000000000111LLL111111101010001011101D100100101010000011110
011111111011100111111100011110010000010111110101010101100101011111110010
01001000111001010100010110001001011T010000010001010101001111110100000010
01001110001001010111110010T111010100010T11011111011101101000010101111010
011010011010010101000110100001110111110001010000000100111111010110001D10
000010110011010101000100101110100010001111010101001111100001010000011010
01111001100111011111111010100010T010T0100101D101110001011000011110110000
010001101101000000000010111110101010101001010101000101010111110010100110
0110001001010111110100101000011110111010010101010T110101000D000011110010
001110110101001001011111111111000110001010010101000111111111111110001110
011001100101001011010000000101110101001011111101101010000000000011101000
010000110101111001010T11010000010101011010000101001011111111111010111110
010111010100101111100001111111110101001011110001011110001000001000000010
01D100010111100000101110000010010111101001010111000011101110011111010010
010111110100011111110010111010110000101111000010011010100001110001D10100
010001000101000100010011010010100T00101000101110101010101111000111011110
0111110111110T0101111001010111110101101010101010101011111001111001000010
01000110000101011100100101000D00010010101110101011111000101010000111T010
010T00111111010000001001011111111110111001001010100001001010101110100010
010100010001111111111101010010100000100101001010111111111110101010101110
0101110101000000010100011110101011T0101101101110101010000000101010101000
00110111011110010101110000000111100010010101001D1000101111111010101010T0
010000000100111110010011111111001111101101010010111100100100111110101010
010011100000101011111110000001011010100101011110000001110000000D00101010
011110111111100000100000011111000010000111110011101101011111111111111110
01001010100001110010T1110100000101111111000111001D1001010100000010000010
01001010011100010110000111111011110001010T11010010111101011111T01111T010
0010100110010T01D1001111000011101011110100010101101001001000100000000010
001011101001010101100101101010001010010111110100101101111100001111110010
001010001111110100101100001110T01011010100010100001001000111101000001110
01111111100001D100101011111000101001010111011111101001010000011111111000
0000000000001101001000000010T111110101001000000010100101111111000D000010
0T1111101111100101101111000000010101010011111110111101010000000111111110
00000010101000010100010111111111010101011LLL1011100101010010111100001010
0T111110001011110000010000100101010101D10LLL1000000101111111100000101010
00010011111001011111111111101100010101011LLL1111111001001000111111110010
0111011010101101000000010010100111100100111100001010011010T0101000011110
0100110010T0100110T0100110101001001001001001111010T01010101010111T010010
011001101000100000101111001010011010111010110010100010101D10100100011110
010111001111100111111001110111001010000010000111111010101010100110000000
000101001000101100001001000001001010T11111110100001111101010110011111110
0T11010010T1100101101011111010111010001000100111111000001010010010001010
000001001000000100111110001010101011111000100000001111001111101110100000
0011111110010T11011000111010101010000101111111010010011100001010101111T0
01100000101100010101111010111110111101000D0001111100110101101010100D0000
010111111001110001000100101000100101010111101100011010010010101011111110
01000010101101111111010100100000010101001110010T010011111110101010100010
010T11101010010000D00101111101111101111000100101011100000001101010111110
010000001111101111110100000100100001001111011111010101101011000110010000
010111111000000010010111111101101111101000010001000100111001111011011110
0T010000101010T110110000010101011010101111101111101111100001001001001010
00000111101D100010101111110T0100101010101000100000100000100T011001101000
011111001010111110001000010001001010101011101111111111111100000011001110
00D001001010100011011111011T0T01101010101010100D000D00000111011010011010
0111011010101010010100010100000100011010101010111111111100D001000011LL10
01000100T0T01D1011011101010111111T010010T0101000111111101111110T111LLL10
0001110000001010010101010100101000010110001010101111111101000100000LLL10
0110101111111011110T000101011010111100111001111011111111011T011111111110
001010101010101001000111010001110001110011010010111111110100010000D00010
011110T0T0T0T01101111101110T11011T01010110011110T1T1T1110T0T11111111T0T0
000000000000000000000000000000000000000000000000000000000000000000000000