000000000000000000000000000000000000000000000000000000000000000000000000000
011111111111111111111111111111111111111111111111111111111111111111111111110
01LLLLLLLLLLLLLLLLLLLLLLLLLLLLLLLLLLLLLLLLLLLLLLLLLLLLLLLLLLLLLLLLLLLLLLL10
01LLLLLLLLLLLLLLLLLLLLLLLLLLLLLLLLLLLLLLLLLLLLLLLLLLLLLLLLLLLLLLLLLLLLLLL10
01LLLLLLLLLLLLLLLLLLLLLLLLLLLLLLLLLLLLLLLLLLLLLLLLLLLLLLLLLLLLLLLLLLLLLLL10
01LLLLLLLLLLLLLLLLLLLLLLLLLLLLLLLLLLLLLLLLLLLLLLLLLLLLLLLLLLLLLLLLLLLLLLL10
01LLLLLLLLLLLLLLLLLLLLLLLLLLLLLLLLLLLLLLLLLLLLLLLLLLLLLLLLLLLLLLLLLLLLLLL10
01LLLLLLLLLLLLLLLLLLLLLLLLLLLLLLLLLLLLLLLLLLLLLLLLLLLLLLLLLLLLLLLLLLLLLLL10
01LLLLLLLLLLLLLLLLLLLLLLLLLLLLLLLLLLLLLLLLLLLLLLLLLLLLLLLLLLLLLLLLLLLLLLL10
01LLLLLLLLLLLLLLLLLLLLLLLLLLLLLLLL0LLLLLLLLLLLLLLLLLLLLLLLLLLLLLLLLLLLLL110
01LLLLLLLLLLLLLLLLLLLLLLLLLLLLL0L010LLLLLLLLLLLLLLLLLLLLLLLLLLLLLLLLLLLL110
01LLLLLLLLLLLLLLLLLLLLLLLLLLLL01001LLLLLLLLLLLLLLLLLLLLLLLLLLLLLLLLLLLLL110
01LLLLLLLLLLLLLLLLLLLLLLLLLLLL01111L0LLL1LLLLLLLLLLLLLLLLLLLLLLLLLLLLLLL110
01LLLLLLLLLLLLLLLLLLLLLLLLLLL0000011T1L0T0LLLLLLLLLLLLLLLLLLLLLLLLLLLLLL110
01LLLLLLLLLLLLLLLLLLLLLLLLLLL01101100L00100LLLLLLLLLLLLLLLLLLLLLLLLLLLLLL10
01LLLLLLLLLLLLLLLLLLLLLLLLL100010011101011T1LLLLLLLLLLLLLLLLLLLLLLLLLLLLL10
01LLLLLLLLLLLLLLLLLLLLLLLLL1T111100100111L0LLLLLLLLLLLLLLLLLLLLLLLLLLLLLL10
01LLLLLLLLLLLLLLLLLLLLLLL1L0000L1001111000LL0LLLLLLLLLLLLLLLLLLLLLLLLLLL110
01LLLLLLLLLLLLLLLLLLLLLL11011T1L101101LL110010LLLLLLLLLLLLLLLLLLLLLLLLLL110
01LLLLLLLLLLLLLLLLLLLLLLL1D100L010100101100010LLLLLLLLLLLLLLLLLLLLLLLLLL110
01LLLLLLLLLLLLLLLLLLLL1L110110L01110010L111110LLLLLLLLLLLLLLLLLLLLLLLLLL110
01LLLLLLLLLLLLLLLLL111111101LLL10010010110100LLLLLLLLLLLLLLLLLLLLLLLLLLL110
01LLLLLLLLLLLLLLLLL1T111110101111111011100101L0LL0LLLLLLLLLLLLLLLLLLLLLL110
01LLLLLLLLLLLLLLL111111111011000010000011111101001000L0LLLLLLLLLLLLLLLLL110
01LLLLLLLLLLLLLL1T11111111LL1011011111110000011101111010LLLLLLLLLLLLLLLL110
01LLLLLLLLLLLLLLL1111111111L10100100000100T0010000010010LLLLLLLLLLLLLLLL110
01LLLLLLLLLLLLLL1T111111D0LL1011010T111110101110T0011110LLLLLLLLLLLLLLLL110
01LLLLLLLLLLLLLLL10001110111111001000000101010001011000LLLLLLLLLLLLLLLLL110
01LLLLLLLLLLLLLL000101110000001111011111111111T010010110LLLLLLLLLLLLLLLL110
01LLLLLLLLLLLLL1T11110111111T001011000010000000010011100LL0LLLLLLLLLLLLL110
01LLLLLLLLLLL0L100101000011110110011110101110111100100010010LLLLLLLLLLLL110
01LLLLLLLLLL0100T0101001011110101110010101110100110101110110LLLLLLLLLLLL110
01LLLLLLLLLL011010011111000D000001010001D111011000010010010LLLLLLLLLLLLLL10
01LLLLLLLLL00010110001011011111111010111011110111111001001LLLLLLLLLLLLLLL10
01LLLLLLL00010100101000011001LLL01010100000000101001101001LLLLLLLLLLLLLLL10
01LLLLLL011110111101111101000LLL0101011111111110T0101111110L0LLLLLLLLLLLL10
01LLLLLLL100100001010100010111LL0101D100000000001010100000L010LLLLLLLLLLL10
01LLLLLL0T0110T01100011111110111111101000011111100101001011110LLLLLLLLLL110
01LLLLLLL0001010011111000001010000010111111001001110010111000LLLLLLLLLLLL10
01LLLLL0011111111100000000010111111100100100010010110110010T0LLLLLLLLLLLL10
01LLLL01110LLL0001011111111101000001101011011111100000111101LL0LLLLLLLLLL10
01LLLLL01LLLL111010100000001011111000010000100001111111001010010LLLLLLLL110
01LLLLL0T0LLLL110101011111110000011111111T01111001000010111111110LLLLLLL110
01LLLLLL1LLLLL11D1LTL0D0000110T111000100000100100101101000000000LLLLLLLL110
01LLLLLLLLLLLL110101L11111101000D0000111111000100101001111110LLLLLLLLLLL110
01LLLLLLLLLLL1110T0LL111111L011111111100101011111111101LLL10LLLLLLLLLLLL110
01LLLLLLLLLLLL1111LL11111T1L01000100011010T01LLL0000101LLL0LLLLLLLLLLLLL110
01LLLLLLLLLLLLL1LLL1111111LL010T0101101010000LLL00011011LLLLLLLLLLLLLLLL110
01LLLLLLLLLLLLLLLLLL11L000LL0101010010101111110L1111LL011000LLLLLLLLLLLL110
01LLLLLLLLLLLLLLLLLLLLL0110001011110111001010111001LLLL011110LLLLLLLLLLL110
01LLLLLLLLLLLLLLLLLLLLL01001110100000D00010T01000110LLLL0D00LLLLLLLLLLLL110
01LLLLLLLLLLLLLLLLLLLLL011110LL111T1111T010000LLL10LLLL11111LLLLLLLLLLLL110
01LLLLLLLLLLLLLLLLLLLLL0100100110001111101111T101110LLL11111LLLLLLLLLLLL110
01LLLLLLLLLLLLLLLLLLLLLL00110LL101111111100100L01010LLLL1L1LLLLLLLLLLLLL110
01LLLLLLLLLLLLLLLLLLLLLLLL0L11110111111001110LLL0L0LLLLLLLLLLLLLLLLLLLLL110
01LLLLLLLLLLLLLLLLLLLLLLLLL0100L0111111T11010LLLLLLLLLLLLLLLLLLLLLLLLLLL110
01LLLLLLLLLLLLLLLLLLLLLLLLLL0LL1T1111110000110LLLLLLLLLLLLLLLLLLLLLLLLLL110
01LLLLLLLLLLLLLLLLLLLLLLLLLLLLLL111LLT1LLLL00LLLLLLLLLLLLLLLLLLLLLLLLLLL110
01LLLLLLLLLLLLLLLLLLLLLLLLLLLLLLLL1LL1LLLLLLLLLLLLLLLLLLLLLLLLLLLLLLLLLL110
01LLLLLLLLLLLLLLLLLLLLLLLLLLLLLLLLLLLLLLLLLLLLLLLLLLLLLLLLLLLLLLLLLLLLLL110
01LLLLLLLLLLLLLLLLLLLLLLLLLLLLLLLLLLLLLLLLLLLLLLLLLLLLLLLLLLLLLLLLLLLLLL110
01LLLLLLLLLLLLLLLLLLLLLLLLLLLLLLLLLLLLLLLLLLLLLLLLLLLLLLLLLLLLLLLLLLLLLL110
01LLLLLLLLLLLLLLLLLLLLLLLLLLLLLLLLLLLLLLLLLLLLLLLLLLLLLLLLLLLLLLLLLLLLLL110
01LLLLLLLLLLLLLLLLLLLLLLLLLLLLLLLLLLLLLLLLLLLLLLLLLLLLLLLLLLLLLLLLLLLLLL110
01LLLLLLLLLLLLLLLLLLLLLLLLLLLLLLLLLLLLLLLLLLLLLLLLLLLLLLLLLLLLLLLLLLLLLL110
01LLLLLLLLLLLLLLLLLLLLLLLLLLLLLLLLLLLLLLLLLLLLLLLLLLLLLLLLLLLLLLLLLLLLLL110
01LLLLLLLLLLLLLLLLLLLLLLLLLLLLLLLLLLLLLLLLLLLLLLLLLLLLLLLLLLLLLLLLLLLLLL110
01LLLLLLLLLLLLLLLLLLLLLLLLLLLLLLLLLLLLLLLLLLLLLLLLLLLLLLLLLLLLLLLLLLLLLL110
01LLLLLLLLLLLLLLLLLLLLLLLLLLLLLLLLLLLLLLLLLLLLLLLLLLLLLLLLLLLLLLLLLLLLLL110
01LLLLLLLLLLLLLLLLLLLLLLLLLLLLLLLLLLLLLLLLLLLLLLLLLLLLLLLLLLLLLLLLLLLLLL110
01LLLLLLLLLLLLLLLLLLLLLLLLLLLLLLLLLLLLLLLLLLLLLLLLLLLLLLLLLLLLLLLLLLLLLL110
01LLLLLLLLLLLLLLLLLLLLLLLLLLLLLLLLLLLLLLLLLLLLLLLLLLLLLLLLLLLLLLLLLLLLLL110
01LLLLLLLLLLLLLLL1LLLLLLLLLL111111111LLL11111LLL111LLL1LLLLLLLLLLLLLLLLL110
011111111111111111111111111111111111111111111111111111111111111111111111110
000000000000000000000000000000000000000000000000000000000000000000000000000