0000000000000000000000000000000000000000000000000000000000000000000000000000000000000000000000000000
0000000000000000000000000000000000000000000000000000000000000000000000000000000000000000000000000000
0000000000000000000000000000000000000000000000000000000000000000000000000000000000000000000000000000
0000000000000000000000000000000000000000000000000000000000000000000000000000000000000000000000000000
0000000000000000000000000000011000111111111111000000000110000000110001111111111100000000000000000000
0000000000000000000000000000011000111111111111000000000110000000110001111111111100000000000000000000
0000000000000000000000000000011000000000000011000000000110000000110001100000000000000000000000000000
0000000000000000000000000000011000000000000011000000000110000000110001100000000000000000000000000000
0000000000000000000000000000011000000000000011000000000110000000110001100000000000000000000000000000
0000000000000000000000000000011000000000000011000111000110000000110001100000000000000000000000000000
0000000000000000000000000000011000000000000011000111000110000000110001100000000000000000000000000000
0000000000000000000000000000011000000000000011000111000110000000110001100000000000000000000000000000
0000000000000000000000000000011000000000000011000000000110000000110001100000000000000000000000000000
0000000000000000000000000000011000000000000011000000000110000000110001100000000000000000000000000000
0000000000000000000000000000011000111111111111000000000111111111110001111111111100000000000000000000
0000000000000000000000000000011000111111111111000000000111111111110001111111111100000000000000000000
0000000000000000000000000000011000000000000011000000000000000000110000000000001100000000000000000000
0000000000000000000000000000011000000000000011000000000000000000110000000000001100000000000000000000
0000000000000000000000000000011000000000000011000111000000000000110000000000001100000000000000000000
0000000000000000000000000000011000000000000011000111000000000000110000000000001100000000000000000000
0000000000000000000000000000011000000000000011000111000000000000110000000000001100000000000000000000
0000000000000000000000000000011000000000000011000000000000000000110000000000001100000000000000000000
0000000000000000000000000000011000000000000011000000000000000000110000000000001100000000000000000000
0000000000000000000000000000011000000000000011000000000000000000110000000000001100000000000000000000
0000000000000000000000000000011000111111111111000000000000000000110001111111111100000000000000000000
0000000000000000000000000000011000111111111111000000000000000000110001111111111100000000000000000000
0000000000000000000000000000000000000000000000000000000000000000000000000000000000000000000000000000
0000000000000000000000000000000000000000000000000000000000000000000000000000000000000000000000000000
0000000000000000000000000000000000000000000000000000000000000000000000000000000000000000000000000000
0000000000000000000000000000000000000000000000000000000000000000000000000000000000000000000000000000