000000000000000000000000000000000000000000000000000000000000000000000000000
000101111111111010111111111010000110111110101111110101101011111111111110100
0011001000000D00100001LLL10111111100100010101000010100101011100001111110110
0110001011111111101001LLL10101010011110000101011110100101011101100D00010100
0011011001000000101111LLL1110101100001111110111010011110100D001001111010110
0001110001111111111LL1LLL10001001011100010001000110100101111101111001D10010
011001110000000000LLL1LLL10101010010101010111010000001110010101001011010110
001101001111011111LLL100010101010010001010001011111111000110101001010000100
010111100001000101111111111110010011111010111010000000010010001001010110100
010010001111111100000000001011010101001010001010100111010111111001010011100
010011110000D00000111111101000010101111110011111111010011100001011011010010
01010010100111011100011110101011010000001110010100001101000010100011LL10010
01011110101101010101000D0011100101011110100001000111100101101011011LLL10010
0111000010000100011111111010001101000010111111111100100100101000010LLL10110
000100101111111110000100111111100111001110010000011110111110101101110010100
001110101000000010101100010001001101010000010010100000001010100100010110110
011000101010101010100011110101001000010110111010100001101001111101010011100
001111101110101111101010000101101111110010101011111111001001000101011110000
010101000010100000111010011100100000010110101010000001001001111101000011110
0101010111101011000D0011110110111111111010100111111101011111000111111110010
010101010010100111111000000100100000001011111100001001010010111000000011110
010001010111101100001011111100111111101010000111101111010010101010111001010
011011100000101011101010010110100000111110110100011001010010001010100101010
001000111110100000101011010010001101010010011110001001010111111011111101010
01111100001111111110101001111011100101101011001111111101000D000010000011010
0100010011100001001010101LLL11001101001010100110000100111111111010100101010
001111111011110100101D101LLL01100101101010101000110110100010000010110101010
0010000010100101001110101LLL001011010010101010111101001010010101101001D1010
00100111100111010010001011111010011100001001100D000110101101010100100101010
011111001010000010100111100011110001111111001111110100100111111111101100010
000001001010111111110100100101000100101001111000001110110100000000000111110
001000010010100000000101110101011100001000001111111010010111111010101001010
0111111101101111101101000001111001110111110100000D0000011101001110101111000
010100010010000010010101110100100001010101010010111111110001000000101001110
010101011111111111110000100100111111010100011010100010001101111111111101010
010101110000000101011111101101010001010111110010111011001001001000000100000
010000010111111100000010100101000101010000000111101001111101001011110110110
01111111001010001111111011111111110111111111010100100100010101111010001D100
010001010010101101010100100000010101000000010101000101010111010100101010110
000111010010000101010000111001000101011101010101111101110001010111111010100
011000010111111101010110100T11111111110011010100000100010100010010010010110
0011111111000010010101001110001010000011100T0111101110011111000010011010100
010010000101101111111110101011101110000010000010001011010000011111101010100
01001011110010101010101110001010101111111111101110100101110011000D000010100
0111110000101D1010001001011110101010000D00001010110011100110101111111110110
0000011111111010101110010100101D10101011111010100001100000000000D0001011100
011111010100001010100111010010101011111000101000111011100101111111101000110
00D0000001011110101101010011101010000D00001011111010101101D1000000111110000
011111111101010010100101001000100011111101100101000010011101011100000011110
0000D0000001011101110101111101111010101001000101001111010001000111111000000
011111111101010101010101000101001010101000111101111000011111111100001111110
010000100001010001010101010101111000001001100101001001010000100111100010010
011110111111011100010111110101000011111101000101101111000000110100111011010
00101D100001010101111100000101010010000101111100110010111111010111001000010
00101011110101010100D001111101010110111101000000100000100000010101011110010
001D10100101110100011110101001111100101001001110111111111111100001010011010
01101011010100010111111010111000D000100011111000100001001000111111010110000
0100101LL101101101111110101010111110101110001011101001101110000D00010011110
0101101LLL10100011111110101010010100101011101000101110101011111111010010010
0100101LLL10101101111000101101010101100000011111111000101010000010011110010
010010101111100101110111001001010000110111110000001111001011111100010010010
0011100111111101D1110001111111011110100100011111101001011000100111011111010
00100111111111D1011111101000010000111011100100D0001001001010110100010000010
011101111111110101110000100000011110001011010111001011100010000001011111010
000101111111000100010110111111000010101001010110111000111111111111010001110
011100000000111111010100100001111110101001010110101010000000000000011000100
010110111111100001010111101101000011101011010110101011111000011111101110100
01001010000011110101001010011110100100001001D110101010001111110000000100100
011010100010100101011010100100101101011110110110101010111010011101110111110
0100101111101101001000101110001011D1000000010111001111001010010111010100010
011100100010000100111110101011101101111111010111100100000010100001010101010
010110101110111101100000101010011101000101010111110111111110101001010111010
01010010001D100101000111110010111101011101100111110101000000111101011001010
010111011110101111011100011110111101010100101111110101111111100101001111010
000000000000000000000000000000000000000000000000000000000000000000000000000