000000000000000000000000000000000000000000000000000000000000000000000000000
0T0T111010T0100T010010T0T0T0T1101010010001010101111101110T011110100111011T0
0100001D1010110101111010101000111111111111110110001001110101110011110011000
01111010101D1001010000111011010001000000001000111110111101010010100010100T0
010010T01110100101111110000111000111110000111010000111110101011110T01011010
011010000010100101001000111100111010001111101010T11100000101000010101010110
0000111111101001010010T001000100101010000010101000D00111110110T01D101010100
0100100D0010110101001010011111001010110T00100111011101010001101010101010110
011010111010010101001010101001001010100101111101010001010T11101010111110100
0100101110101111011010101011110111111001000D0000011T010100001D1010100000100
01001000001010100010101110100101000001110111111T010001001110101111101011110
0111111111101010T0101010000001010T11000100100000011T01101001101000011001010
010000000010101010101011111111010001111100111111110000101000001010010011010
00001110111100101010101000000101011000011101LLL0D00110101111111011011010110
0T111001100111101010111111111111001011110001LLL1110010100001001110010000100
00001010100000111010010000000010101010010T01LL11011010111011001000111111100
011010100011111000111100T01111101010111101011110000010101001111111100000110
010010111110001101100010101000111010001001000010T11111101010000101001010000
011111000101110111000010111110001010T010110010100000001010100T01000011111T0
0000011000000100011111100D000111101010100110111111111111101101011110100D000
001110111111111101000011111100001010101011001000001000001010010101001011110
0110100000D0000111101110001011T11010101110011111T01111T01110111101001000010
0000111111110T11LL100101101011001D1010010001000000001000001D10011001111T010
0T1110000001000LLL10000100101110101011010111101111T011111110100011010000010
000010010111011LLL111111011100101010011111001D1111100001000010110111111T010
01011101100000111110010111011011001111000011101111111T010110100100000000010
01110000100010100010110100010011110010101000000000D000010011110110111111110
00101111111111101010100111010111111010101111111011111T010010011101100010010
00101001010001001110101001010111111011101000001010000001111000010100T010010
0010000101111101001010100001000011100101111110001111111100101101D10010T0010
011111110000000100001111111110100D00010100001111100100010110100101111000110
01000000011101111101000000001D101111111111011010100000010000100100100111100
01111001010101000111110T1101101110001000001100101111111111T0100100000100010
010011110001110100000100010000000000101111100010100D00000000101111111110010
0100010111110011111001111111111111111110001111100011111111111000D0000010110
010111010010000010101101000001000000010000101011T01010100000101111101000100
0100101110111111101D100010T1110T1111010111101000001010001111111000111111100
0100001010100101001011T01000010000010101000010111100111100100010T0100000110
011111100000000001100000100100001111111101011110010000011010T11010010T01010
00010001111111111100100111111111100010T001D10000011101001100000010010101000
0101100000010010000011110100000011101000110101111001011101111111100101011T0
01D101111110101011111010010110T0000111111001D1111101D1110000100010010101000
01010100001010011001001001001011101100D0000101111T0101111110101011111111110
01000001001111110001011111001D111D10011111110111000101111110111101000010010
00111111111000010111010001011011101101000000000011110111T110100101000000010
011010100101001101010101110100000000011111111100100000001110100101111111010
001000100101011000000T0100011111111111000010010110100010T010100100010100110
01101110011111001111110101000000D000D00110100100101111101010101110000111100
00011001110001101111110011111111111111111D100101111000001001001011110100110
0T110101010T000011111111111111111111111110101111001011111001011000010100100
0000010000011111111111111111111111111111100000D0011110001001010101000100100
0T1111111111111111111111111111111111111111111111000000T01011010101110111100
0111111111111111111111111111111T11111111111111111011101010101001001LLL10100
0111111111111111111111111111111111111111111111111D10111010101011001LLL10100
011111111111111T111111T111111111111111111111111110100D00101010100111LL10110
0111T1111111111111111111111111111111111111111111101111101111101011011110010
01111111111111111111111111111111111111111111111110000011100D001D10000000110
011111111111111111111111111111111111111111111111111111010011111010111110000
01111111111111111111111111111111111111111111111111111101011000101D100011010
01111111111111111111111LLL11111111111111T111111111111T010101011010111101110
01111111111111111111111LLL1111111111111111111111111100010101010010000101000
01111111111111111111111LL111111111111111T1111111111101111101000011111001110
0111111111T1111111111111111111111111111111111111111101000111111101001001010
01111111111111111111111111111111111111111111111111110111001000010T001111010
01111111111111111111T111111111111111111111111111111110011011110100010000010
011111111111111111111111111111111111111111111111111110001010011001111111110
01111111111111111111T1111111111111111111111111T11111T0111011001111001000000
0111111111111111111111111111111111111111111111111111001000010010011011111T0
011111111111111111T11111111111111111111111111111111101111110011100101010000
0T111111111111111111111111111T111111111111111111111101000000110110101010110
0111111111111111111111111111111111111111111111111T11011T0111100000101010010
0T1111111111111111111111111111111111111111111111111100000100111111101011110
0111111111111111111111111111111111111111111111111111111011000D0000101010000
0T11111111111111111111111111111111111111111111111111111010111111T0T011111T0
000000000000000000000000000000000000000000000000000000000000000000000000000