000000000000000000000000000000000000000000000000000000000000000000000000000
0T001001111111111111101101111010000010111111111010110T011111101101110000010
010111100000100101001010011110111111101000001011111001011111101001001111110
01D100011111101100001010000D00001010111010001010000011000011101001101000010
01010100000000001110101111111110100000001111001111T010011011101001001000000
0101011111011100010010101000000111111111010001101000100100111011110111111T0
01D100000111011T01011010111110110100000001001100011010111011101010010001000
01011111100001000111001010001D100111111111101000010010100011101010111T010T0
01000000111111001001101011T0101000000000D0001011110010110111101010100001010
0011111110010110100010101000101011111111110010010011111001111D1010111011010
011001000111001111001111111110101000000001011101000000101111101010101110010
000001000001001LL1111000000100101010011101010101100T01100001101011100001110
010111101111001LLL100111110101111011010111110000110100111100001D10001101000
01D100110000011LLL000000010101000010010000101010010101100011111011101001010
010110101111110111111111110111111110111010101011110100111110000000101001110
010000T01010010100000000010100000010101110111000100101100011101110101111000
0111000010101101111111111111111001101000101001001011110011101110111110000T0
011011101010000000000100000010111011000110111101111001110000000000000011110
0000010011111110T111110011101000000110110010010000100000111T01011111T111110
011T010100000010001010111011101101001D101011000111101111100001D111111111110
01000101011111110010101010001011D10110101001111000101010000T010111001111110
011001010100010111101000101110110101001011101000001000111101010000101111110
001111010100010101000111101010110101001010001111111111100011111111100111110
000001010111100101110100101010100111011010111010100000111010000001010111110
0T111101000011110101111100101000100111001001001011111000011111T011010111110
000001011110100001010000011111111010011010010100001011111100000010010111110
0T1T11110011111T01011111110001001010010011111110101001010110111010010111110
0100000000100D0001D1000100010111101001011000001111100000000010101101D111110
010111111000111111010100111101010011110010011101000011111111101001110111110
011000001110000001010111111101010100010011110101111110000000010000010111110
01101111LL110011110101111111010101110110100100010000000T011111111111011T110
01101001LLL1101000001111100001010001001111010T1101111T010100100001000111110
01100011LLL010100111111101111111110111100001000100100001110011111101011T110
01111101111111110111111100000000D0000011110101111010T010010010000101D111110
01111100000000010001111111111111111T010101010100001010111111111011110111110
011111111T111101110T1111000000000D0001010101010T001010100000001110010111110
011111111000011001000000011111011110010101010101011111111111010100100111110
011111111010001111111110010001D100101111110101D100000D000010010101111111110
011111111D101110000000110001110101111000D0010101111111111010110101111111110
000011111011101011111101111100000000100111110100D00010000111100101111111110
01110001100D0011000D0001001011111111101101011001110010100100000011111111110
010111000111111011111111001010010010100101001111010111111111111100111111110
010001110000000000001010011000010010100101101000000100000001000110111111110
01010001111111111111000001011101011011001100111111111111110100101D1111111T0
01111111001000000D0001111100011100100100100101000100D0000101101010111111110
0000101000100111111111000001110011101100100101010T011111111010101011111T0T0
0T11101110111100000D0011111100001010000111010111000000D00000111110111111010
000001001000000001111100LLL101111010110101D10100011T11111110010000111111010
011111100010111111000101LLL10010101001D101010111110001111111010111011111010
0010001111111010100101011LL10010T01101010101001001010111111101D101000001D10
0010T110010010T01001110011110110001000010100111011011011111T010100011101010
011000000101100010010011101000001110111101001010010010100000000111110101010
010111110100011111100001001011111000010001011000011110001111111000000101010
000010011111110000111101001010101111010111001111010011111000000011110101010
0T1110010010010T00000011101010101000110010001001010010101100101110011101010
0001001110100101011101100010101011T010100111101101110010101111100000000T010
001101100010110110011101111010101000101001010010010110101010000011111100010
011000111110010101001001001011101011101111010110010011001D10011010010111110
010010100001110101001001000000101100101000010011110001101011110010100000010
01011011110000010110101111111110100110111111011LL11000100001010010101111110
01001000011101010011100000001010111010000101001LLL1110111T01011110101000010
011010101101111111100111111110101000111T0101001LLL1010010001000011101111100
00101D1000000000000001000010101011101000010111100010110101111111001D1000100
011010111110111000011101001010101001100101010011011010010010010000101010100
000110010011001111110101111010101000101111010010010011011010011111001011100
011111010101101001000100001010111011100001011010011001010010010001011100010
0111110101001D10010T1101001010001010110111100011100011011111010101010110010
01011101110010100100010111001010100010010010100011100001LLL10101D1000011110
00100001001110100110000101111011111000010111111000111001LLL1010101101110010
01111111001001110011110001010010000111110100001110101101LL11010101001011010
00010101001001011000010111010010T001000101111101001001010110010101011010010
0T11010101111100101111001000101010110011100000011110110T0100010101010010010
000001010000001110100100101010101010111011010011001001000100111101010011010
0T11110111111110101111111011111110T010101001111011110111101110010T0111010T0
000000000000000000000000000000000000000000000000000000000000000000000000000