000000000000000000000000000000000000000000000000000000000000000000000000000
011111011111101111101101110010111111111010101000010111101111100001111010010
011111D1010010000010010100111000D000001011101111111100001010111111000111110
010111010101100110110101000011111111101010011000100101111010000001010100000
010101010100111100011101011000100001001010110010100100001001111111110101110
010010000000100101000101001110000001101011101110100101111101010100010101110
0101111111111011110101010010111111101110100010001001000D0001010101000100D00
010001000001000001010111100000001000001111101111110111111111010101110111110
011111001101111111110000111111111011111000001010000001000000110100100001000
000001111000000000010111100010001010001011101010100111011100100101101101010
011101001111111111010100111010101010001000101010110101110011100100111001010
000100011001010001110100000011101011111111111110010100001010110100100101010
011111110000010110010101110010001010000100000000110110101010000101111101010
01000000001101D101011101010110011011110111110101100010101111110100000101D10
010111111101D101010001010101011100101001000001110010101D1000010101100111010
010100000101010101110101010100010110100101111010001011101001010100101100000
0101110111000001000101D10101011100011101010000101111010001010101101D1001110
01000101010111010101010101D100011111000101111010100101010101010011101001010
0111010101D1000101010101010100110001010111000010110101011111011010001111010
0001010101010101111111010001101011111100011111100001D1010000100011110101010
0111111101010100000010011110101000D0000100010001111101111111111110010100010
001000100101010101101010001010100111111101011111000000000000000010110011110
000010111111010100111111101010110111111101100D00001111111111111010000110100
0111111000D00111000D000001111LL10111111100101111111LL0100101000011111100000
0100000011110001111111111101LLL1011111110110100001LLL0100001011110000111110
0111111000011011000001000001LLL100D000000010101001LLL0101101000D00000000000
000010101110100011110000100111111111111111111011111111100101111111111110110
01101010101010101000111111110010000100000D001D100000000101110100100D001D110
010010100010111011111000000000100101001111101011110100110100011110111010110
010010111111001000000001111101010101111000000000010110101111000000101010110
011110000001111100111101001001010101000010011111010010101000011111101010110
00001111111000011110010000100101110101111111000000101D101111010000001011110
011110100010111101000111111101000101010001010111111010111001111111101011000
0100101010100000011111LL100111110111010101010010001010000000101010001D10110
0100001D10111010000000LLL1010001D1001101D1001110001111111111101010011010100
0001111010101111001011LLL10001110110011101010011111001000000100011010000110
01110100101001011110011111011101LL11001001010010001101110010111110111101100
01000000101011010011110001110101LLL1111001111111100001011011010000100001010
01001011101010011110100T00D00101LLL0101110000000111101001D11011111101001010
00111110011010110010110TTTTT01011111101011110100000101011011000001001111110
01000011100010000000000TTTTT00001000011010011111110000000011111101111000010
0111101000011010110TTTTTTTTT01111011010010010000000111011101111110001111010
011110111111011101DTTTTTTTTT01001001011011011111100100110101110001001001010
01111D1000000001010TTTTTTTT001101101D10010001010111100100001110101011101010
0111101000011111110TTTTTTTT0101010010100111010000001001110101101D1000001000
0111101111110000010TTTTTTTT010101011011010011111010101100010010101011111110
000000010001111000000000TTTD10001001010010010001010001000111100100010100010
011111110101010111111110TTT011111101000011011111111111110100001111110001110
010100010111010000000010TTT010010101111010010000D00000011111111010011110000
010110110100010111111010TTT0100101010001111110111111111000D0001010110011110
01001000010111000000101000011111000101010000101000D000101111101010011100100
010010111100001111111111111100011101011110101011111100110111101010010100110
011010000011100000100100000101110101000000111010000110000101101010010111010
010011001010111000000100010100010000001111100011010011110100101111010000010
010101101010001111111110111101111111110010111101D11010000111000000011110010
010100101000111000D00010001001001000010010100101011011100010111111010011010
01010000111110110111011100110100100000111010000100101011111000D000010001110
000111111000001001110101100101011111101010101111101010100011111111111000D00
011100000011111011000000111101010100100010111010001010100001010100001111110
010001111110001011011111100001010100111111000011111010111101010111000100010
010111010001101001D10100110011010110000000101110000010100101010001110101010
010101011101001101010101101110010011100000100101111110010101110011010101000
011101010101111000000100101010111010111111111101000010010101000110011101110
0000110101000011111111101010101010100D000D000101011011110101111100010001010
011110010100101000000000101011101011111111110101001110100101000110011111010
0000100100111110111101111000001D1011111111100101000010100001010101110001000
01101001100001000001D100111101101011111111011101011110101101010100010111110
001111010011110111110100100101001011111111010101010010111001011111110000100
001001010010000000010110100101001011111100010101011011001101100000011101100
001001011011101111110100110101001011111101111101001010001000111101110100110
011101D10000011010000100100001101011111100100001001011101111LLL110000000100
0101010101011100101111101111101D1000111110101111001010101000LLL011011111110
0101010101000000100100100000001011110111101000101110101011111LL001D10000000
010101011101111111110111111110101010111110111110101011100101011111011111110
000000000000000000000000000000000000000000000000000000000000000000000000000