0000000000000000000000000000000000000000000000000000000000000000000000000000000000000000000000000000
0000000000000000000000000000000000000000000000000000000000000000000000000000000000000000000000000000
0000000000000000000000000000000000000000000000000000000000000000000000000000000000000000000000000000
0000000000000000000000000000000000000000000000000000000000000000000000000000000000000000000000000000
0000000001100111111111111110000110000000000000000000000010000000000000000000000000000000000000000000
0000000001100111111111111110000110000000000000000000000110000000000000000000000000000000000000000000
0000000001100000000110000000000011000000000000000000001100000000000000000001100000000000000000000000
0000000001100000000110000000000011000000000000000000001100000000000000000001100000000001111111100000
0000000001100000000110000000000011100000000000000000011100000000000000000001100000100011111111100000
0000000001100000000110000000000011100000000000000000011000000000000000000001100001100011000000000000
0000000001100000000110000000000001100000000000000000011000000000000000000001100011100011000000000000
0000000001100000000110000000000001100000000000000000110000000000000000000001100111000011000000000000
0000000001100000000110000000000001110000000000000000110000000000000000000001101110000011000000000000
0000000001100000000110000000000000110000001100000001101111111111001111111101111110000011000000000000
0000000001100000000110000000000000111000001100000011101111111111001111111101111100000011000000000000
0000000001100000000110000000000000111000011100000011001100000011001100000001111000000011111111000000
0000000001100000000110000000000000011000011110000110001100000011001100000001110000000001111111100000
0000000001100000000110000000000000011100111110000110001100000011001100000001111000000000000001100000
0000000001100000000110000000000000001100111110001100001100000011001100000001111100000000000001100000
0000000001100000000110000000000000001110110011001100001100000011001100000001111100000000000001100000
0000000001100000000110000000000000001110110011001100001100000011001100000001101110000000000001100000
0000000001100000000110000000000000000111110001111000001100000011001100000001100111000000000001100000
0000000001100000000110000000000000000111100001111000001100000011001100000001100111100000000001100000
0000000001100000000110000000000000000011000000111000001111111111001100000001100011110011111111100000
0000000001100000000110000000000000000011000000010000001111111111001100000001100001110011111111000000
0000000000000000000000000000000000000000000000000000000000000000000000000000000000000000000000000000
0000000000000000000000000000000000000000000000000000000000000000000000000000000000000000000000000000
0000000000000000000000000000000000000000000000000000000000000000000000000000000000000000000000000000
0000000000000000000000000000000000000000000000000000000000000000000000000000000000000000000000000000
0000000000000000000000000000000000000000000000000000000000000000000000000000000000000000000000000000