0000000000000000000000000000000000000000000000000000000000000000000000000000000000000000000000000000
0000000000000000000000000000000000000000000000000000000000000000000000000000000000000000000000000000
0000000000000000000000000000000000000000000000000000000000000000000000000000000000000000000000000000
0011111111111111111101110000000011011000000000000000000000000000000000000000000000000000000000000000
0011111111111111111101110000000011011000000000000000000000000000000000000000000000000000000000000000
0000000000110000000001111000000011011000011111111011111111111111101111111111111101111111111111100000
0000000000110000000001111000000011011000111111111011111111111111101111111111111101111111111111100000
0000000000110000000001101100000011011001110000000011000000000001101100000000001101100000000001100000
0000000000110000000001101100000011011011100000000011000000000001101100000000001101100000000001100000
0000000000110000000001100110000011011111000000000011000000000001101100000000001101100000000001100000
0000000000110000000001100110000011011110000000000011000000000001101100000000001101100000000001100000
0000000000110000000001100011000011011100000000000011000000000001101100000000001101100000000001100000
0000000000110000000001100011000011011100000000000011000000000001101100000000001101100000000001100000
0000000000110000000001100001100011011100000000000011000000000001101100000000001101100000000001100000
0000000000110000000001100001100011011100000000000011000000000001101111111111111101111111111111100000
0000000000110000000001100000110011011100000000000011000000000001101111111111111101111111111111100000
0000000000110000000001100000110011011100000000000011000000000001101111110000000001100000000000000000
0000000000110000000001100000011011011100000000000011000000000001101100111000000001100000000000000000
0000000000110000000001100000011011011100000000000011000000000001101100011100000001100000000000000000
0000000000110000000001100000001111011110000000000011000000000001101100001110000001100000000000000000
0000000000110000000001100000001111011111000000000011000000000001101100000111000001100000000000000000
0000000000110000000001100000000111011011100000000011000000000001101100000011100001100000000000000000
0000000000110000000001100000000011011001110000000011000000000001101100000001110001100000000000000000
0000000000110000000001100000000011011000111111111011111111111111101100000000111001100000000000000000
0000000000110000000001100000000011011000011111111011111111111111101100000000011101100000000000000000
0011111111111111111101100000000011011000000000000000000000000000000000000000000000000000000000000000
0011111111111111111101100000000011011000000000000000000000000000000000000000000000000000000000000000
0000000000000000000000000000000000000000000000000000000000000000000000000000000000000000000000000000
0000000000000000000000000000000000000000000000000000000000000000000000000000000000000000000000000000
0000000000000000000000000000000000000000000000000000000000000000000000000000000000000000000000000000